20251126
?Viva!	¡Viva!
fffff	ƒƒƒƒƒ
?THER	ÆTHER
?bertreffen	Übertreffen
?影	焱影
Sweet Sweet?Magic	Sweet Sweet ♥ Magic 
Raspberry?Heart(English version)	Raspberry♡Heart (English version)
Double??Loving Heart	Double♡♡Loving Heart
Raison d'?tre～交差する宿命～	Raison d'être～交差する宿命～
Love?km	Love♥km
キャトられ?恋はモ～モク	キャトられ♥恋はモ～モク
Pr?ludium	Präludium
旋律のドグマ～Mis?rables～	旋律のドグマ～Misérables～
超!!遠距離らぶ?メ～ル	超!!遠距離らぶ♡メ～ル
表裏一体！？怪盗いいんちょの悩み?	表裏一体！？怪盗いいんちょの悩み♥
D? D? MOUSE	DÉ DÉ MOUSE
Marguerite du Pr?	Marguerite du Pré
ギュ～っとしたい?Prim	ギュ～っとしたい♥Prim
ギョギョっと人魚 爆婚ブライダル	ギョギョっと人魚♨爆婚ブライダル
Amor De Ver?o	Amor De Verão
†渚の小悪魔ラヴリィ～レイディオ†(IIDX EDIT)	†渚の小悪魔ラヴリィ～レイディオ† (IIDX EDIT)
Close the World feat. a☆ru	Close the World feat.a☆ru
DM STAR～関西 energy style～	DM STAR ～関西 energy style～
e-motion 2003  -romantic extra-	e-motion 2003 -romantic extra-
Light and Cyber…	Light and Cyber･･･
ピアノ協奏曲第１番”蠍火”	ピアノ協奏曲第1番"蠍火"
フェティッシュペイパー　～　脇の汗回転ガール　～	フェティッシュペイパー～脇の汗回転ガール～
水上の提督(Short mix from "幻想水滸伝V")	水上の提督 (Short mix from ”幻想水滸伝V”)
鉄甲乙女-under the steel-	鉄甲乙女 -under the steel-
電人イェーガーのテーマ(Theme of DENJIN J)	電人イェーガーのテーマ (Theme of DENJIN J)
Geirsk?gul	Geirskögul
M?ch? M?nky	Mächö Mönky
?u Legends	Ōu Legends
CANVAS feat. Quim?r	CANVAS feat. Quimär
CANVAS feat. Quim?r & BEMANI Sound Team "L.E.D.-G"	CANVAS feat. Quimär & BEMANI Sound Team "L.E.D.-G"
LOVE?SHINE	LOVE♥SHINE
Dans la nuit de l'?ternit?	Dans la nuit de l'eternite
u?n	uən
?LOVE? シュガ→?	♥LOVE² シュガ→♥
P?rvat?	Pārvatī
POL?AMAИIA	POLꞰAMAИIA
ジオメトリック?ティーパーティー	ジオメトリック∮ティーパーティー
OUVERT?RE	OUVERTÜRE
BAHAM?T CORE	BAHAMŪT CORE
オンセン?ヒーロー	オンセン♨ヒーロー
V?ID	VØID
Ignis†Ir?	Ignis†Iræ
ACT?	ACTØ
共犯へヴンズコード	共犯ヘヴンズコード
Jonny Dynamite!,Lisa - paint with stars -,Rio Hiiragi by BEMANI	Jonny Dynamite!,Lisa - paint with stars -,Rio Hiiragi by BEMANI Sound Team "U1-ASAMi"
すわひでお,秋成,かぼちゃ,藍月なくる,NU-KO by BEMANI Sound Team "	すわひでお,秋成,かぼちゃ,藍月なくる,NU-KO by BEMANI Sound Team "八戸亀生羅"
三代目 ADULTIC TEACHERS feat. BEMANI Sound Team "スコーピオン志・	三代目 ADULTIC TEACHERS feat. BEMANI Sound Team "スコーピオン志村"